XSXXXXXXXXXXXXXXXXXX
XWWWWWWWWWWWWWWWWWWX
XWXXXXXXXXWXXXWXXXXX
XWXXXXXWXXXXXXWXXXXX
XWWWWWWWWWWWWWWWWWXX
XWXXXWXXWXXXXXXXWXXX
XWWWWWWWWWWWWWWWWWWX
XWXXXXXXWXXXXXWXXXXX
XWXWWWWWWWWWWWWWWWWX
XWXXXWXXXXXXWXXXXXXX
XWXWWWWWWWWWWWWWWWWX
XWXXXXXXWXXXXXXWXXXX
XWXWWWWWWWWWWWWWWWWX
XWXXXXXXXXXWXXXXXXXX
XWXWWWWWWWWWWWWWWWWX
XWXXXXXWXXXWXXXXXXXX
XWXWWWWWWWWWWWWWWWWX
XWXXXXXXXXXXXXXXXXWX
XXEWWWWWWWWWWWWWWWWX
XXXXXXXXXXXXXXXXXXXX